"----#####----------"
"----#---#----------"
"----#$--#----------"
"--###$-$##---------"
"--#--@-$-#---------"
"###-#-##-#---######"
"#---#-##-#####--..#"
"#-$--$----------..#"
"#####-###-#-#---..#"
"----#-----#########"
"----#######--------"
